10 11
. . . . _ _ . . . .
. . . / . . \ . . .
. . . | - - | . . .
. . . | . . | . . .
. . . | . . | . . xs1,0,0
. . . | . . | . . .
. . . | . . | . . .
. . / . . . . \ . .
. . | . . . . | . .
. . \ _ / \ _ / . .
#c #c #c #c #c #c #c #c #c #c