[16,10]
.n .n .n .n .n .n .n .n .n .n .n .n .n .n .n #c
.n .n .n .n .n .n .n .n .n .n .n .n .n .n .n #c
.n .n .n .n .n .n .n .n .n .n .n .n .n .n .n #c
.n .n .n .n .n .n .n .n .n .n .n .n .n .n .n #c
.n .n .n .n .n .n .n .n .n .n .n .n .n .n .n #c
.n .n .n .n .n .n .n .n .n .n #c #c .n .n .n #c
.n .n .n .n .n .n .n .n .n .n .n #c .n .n .n #c
.n .n .n .n .n #c #c .n .n .n .n #c .n .n .n #c
.n .n .n .n .n .n #c .n .n .n .n #c .n .n .n #c
#c #c #c #c #c #c #c #c #c #c #c #c #c #c #c #c